1,1,1,1,1,1,1,1,1,1
1,4,0,1,1,0,1,0,1,1
1,1,5,2,1,1,1,1,6,1
0,1,0,4,3,0,0,0,0,0
0,0,0,3,0,1,2,1,1,0
1,0,0,1,1,0,6,0,7,1
1,1,1,0,1,0,6,5,0,1
1,1,1,1,1,1,1,1,1,1