1,1,1,1,0,0,1,1,1,1
1,6,0,3,0,0,8,0,1,1
1,0,0,0,4,5,1,6,0,1
1,1,1,0,0,1,1,0,2,1
1,0,0,0,0,0,3,3,0,1
1,1,0,5,0,0,4,0,0,1
1,0,1,5,0,1,5,0,0,1
1,1,1,1,0,0,1,1,1,1