1,0,0,7,0,0,0,0,9,1
0,0,1,0,0,0,1,6,0,0
0,0,1,0,5,0,1,1,0,0
8,0,1,9,0,7,0,7,0,0
0,0,1,1,0,5,0,1,1,0
8,4,0,0,0,0,6,0,1,0
0,0,1,1,1,1,0,0,0,0
1,0,0,0,0,0,0,4,0,1