1,1,1,1,1,1,1,1,1,1
1,0,0,0,0,1,8,1,1,1
1,6,7,0,8,3,1,1,1,1
1,0,2,1,0,0,2,0,8,0
1,2,1,4,0,0,0,6,0,0
1,1,8,3,0,0,3,1,0,1
1,1,1,0,1,0,1,2,1,1
1,1,1,1,0,0,1,1,1,1