1,1,1,1,0,0,1,1,1,1
1,2,0,6,1,6,5,0,3,1
1,6,1,0,1,1,0,7,1,1
0,5,3,0,0,0,1,0,0,0
0,1,0,3,0,1,1,1,0,0
1,0,0,1,3,0,8,1,1,1
1,0,0,1,0,0,0,2,1,1
1,1,1,1,1,1,1,1,1,1