1,1,1,1,0,0,1,1,1,1
1,5,1,5,0,5,1,0,0,1
1,0,0,0,0,8,0,1,1,1
0,0,2,1,0,7,0,0,0,1
0,4,0,1,0,1,0,3,0,1
1,7,0,0,3,4,3,0,1,1
1,0,0,1,4,1,0,1,8,1
1,1,1,1,0,0,1,1,1,1